14
1,6,3,5,5,5,5,7,5,5,6,3,5,4
2,11,12,1,5,5,5,14,3,5,14,11,7,4
9,13,5,5,7,6,3,14,10,2,10,10,11,4
1,5,5,7,13,13,12,8,11,14,10,10,11,6
2,3,7,13,7,5,5,4,10,10,11,15,15,14
11,12,8,1,13,7,5,5,14,11,12,10,10,10
11,7,5,5,5,14,3,6,10,8,1,14,8,10
11,15,5,4,1,12,11,12,10,1,5,15,4,10
10,11,4,3,7,5,12,3,15,5,7,13,4,8
10,11,7,14,11,5,5,12,9,5,15,7,6,2
10,10,8,11,15,5,5,4,1,7,12,10,11,14
10,9,4,10,9,5,5,7,5,13,4,8,10,8
10,3,5,12,3,5,5,13,5,5,5,5,15,6
8,9,5,4,9,5,5,5,5,5,5,5,12,8
