12
1,7,7,7,7,5,7,5,5,5,5,6
1,12,10,8,9,5,12,2,2,2,1,14
1,7,14,3,7,5,4,11,15,14,3,12
1,12,11,12,9,5,6,10,8,11,15,6
2,2,11,6,3,5,13,15,4,8,10,8
11,13,12,8,10,3,6,11,7,4,11,6
11,7,5,6,10,9,13,14,11,7,14,10
10,10,2,11,14,1,5,14,10,8,8,10
10,11,12,8,11,5,5,12,9,5,6,10
10,11,6,1,14,1,7,4,1,5,12,10
11,14,10,3,13,7,13,5,5,6,3,14
8,8,9,13,5,13,5,5,4,9,12,8
